1 1 1 0 0 0 0 0 0 0 0 0 1 0 1 1
1 1 1 0 0 0 0 1 0 0 0 0 0 0 0 1
1 0 1 0 0 1 1 0 1 0 0 0 0 0 0 0
0 1 1 0 1 0 0 0 1 0 0 0 0 0 0 0
1 0 0 0 1 0 0 1 1 1 0 1 1 1 0 0
1 0 0 1 1 0 1 0 0 0 1 0 0 1 0 0
1 1 1 0 0 0 1 0 0 0 0 0 1 0 0 0
0 0 0 0 0 0 1 0 0 0 0 0 1 1 0 0
0 0 0 0 0 1 1 0 0 0 0 0 0 1 0 0
0 0 0 0 1 0 0 0 0 0 0 0 0 1 0 0
0 0 0 0 1 1 0 0 0 0 0 1 0 1 0 0
1 0 0 0 0 0 1 1 0 0 1 0 1 0 1 1
1 0 0 0 0 0 0 0 1 1 1 0 0 0 0 1
1 1 1 1 0 1 0 1 0 0 0 0 0 0 0 1
s
0 0
2 2
2 3
0 4
0 6
1 6
4 5
4 3
7 1
8 2
8 4
6 5
6 8
4 9
4 10
9 12
10 12
10 11
11 10
12 11
13 10
15 11
15 13
s
8 4
10 5
12 4
13 4
13 5
12 6
12 7
13 7
13 10